@@@@@@@@@@@@@@@@@@@@@@@@@@@@@@@@@@@
@                                 @
@                                 @
@                                 @
@                                 @
@          CONGRATULATIONS!       @
@                *                @
@             YOU WIN!            @
@                                 @
@                                 @
@                                 @
@                                 @
@                                 @
@@@@@@@@@@@@@@@@@@@@@@@@@@@@@@@@@@@