@@@@@@@@@@@@@@@@@@@@@@@@@@@@@@@@@@@@@@@@@@@@@@@@@@@@@@@@@@@@@@@@@@@@@@@@@@@@@@@@@@@@@@@@@@@@@@@@@@@@@@@@@@@@@@@@@@@@
@@@@@@@@@@@@@@@@@@@@@@@@@@@@@@@@@@@@@                                                                           @@@@
@@@@@@@@ * @@@@@@@@@@@@@@@@@@@@@@@@@@   @@@@@@@@@@@@@@@@@@@@@@@@@@@@@@@@@@@@@@@@@@@@@@@@@@@@@@@@@@@@@@@@@@@@@@@@@@@@
@@@@@@@@   @@@                 @@@@@@                         @@@@@@@@@@@@@@@@@@@@@@@@@@@@@@@@@@@@@@@@@@@@@@@@@@@@@@
@@@@@@@@   @@@                 @@@@@@                         @@@@@@@@@@                                  @@@@@@@@@@
@@@@@@@@   @@@   @@@@@@@@@@@   @@@@@@   @@@@@@@@@@@@@@@@@@@   @@@@@@@@@@                                  @@@@@@@@@@
@@@@@@@@   @@@   @@@@@@@@@@@   @@@@@@   @@@@@@@@@@@@@@@@@@@   @@@@@@@@@@   @@@@   @@@@@@@@@@@@@@@@@@@@@   @@@@@@@@@@
@@@@@@@@   @@@   @@@@@@@@@@@   @@@@@@   @@@@@@@@@@@@@@@@@@@   @@@@@@@@@@   @@@@   @@@@@@@@@@@@@@@@@@@@@   @@@@@@@@@@
@@@@@@@@   @@@   @@@@@@@@@@@   @@@@@@   @@@@@@@@@@@@@@@@@@@   @@@@@@@@@@   @@@@   @@@@@@@@@@@@@@@@@@@@@   @@@@@@@@@@
@@@@@@@@   @@@   @@@@@@@@@@@   @@@@@@   @@@@@@@@@@@@@@@@@@@   @@@@@@@@@@   @@@@   @@@@@@@@@@@@@@@@@@@@@   @@@@@@@@@@
@@@@@@@@   @@@   @@@@@@@@@@@   @@@@@@   @@@@@@@@@@@@@@@@@@@   @@@@@@@@@@   @@@@   @@@@@@@@@@@@@@@@@@@@@   @@@@@@@@@@
@@@@@@@@   @@@   @@@@@@@@@@@   @@@@@@   @@@@@@@@@@@@@         @@@@@@@@@@   @@@@   @@@@@@@@@@@@@@@@@@@@@   @@@@@@@@@@
@@@@@@@@   @@@   @@@@@@@@@@@   @@@@@@   @@@@@@@@@@@@@         @@@@@@@@@@   @@@@   @@@@@@@@@@@@@@@@@@@@@   @@@@@@@@@@
@@@@@@@@   @@@   @@@@@@@@@@@   @@@@@@   @@@@@@@@@@@@@   @@@@@@@@@@@@@@@@   @@@@   @@@@@@@@@@@@@@@@@@@@@   @@@@@@@@@@
@@@@@@@@   @@@   @@@@@@@@@@@   @@@@@@   @@@@@@@@@@@@@   @@@@@@@@@@@@@@@@   @@@@   @@@@@@@@@@@@@@@@@@@@@   @@@@@@@@@@
@@@@@@@@   @@@   @@@@@@@@@@@   @@@@@@   @@@@@@@@@   @   @@@@@@@@@@@@@@@@   @@@@   @@@@@@@@@@@@@@@@@@@@@   @@@@@@@@@@
@@@@@@@@         @@@@@@@@@@@   @@@@@@   @@@@@@@@@   @                      @@@@   @@@@@@@@@@@@@@@@@@@@@   @@@@@@@@@@
@@@@@@@@         @@@@@@@@@@@   @@@@@@   @@@@@@@@@   @                      @@@@   @@@@@@@@@@@@@@@@@@@@@   @@@@@@@@@@
@@@@@@@@   @@@@@@@@@@@@@@@@@   @@@@@@   @@@@@@@@@   @@@@@@@@@@@@@@@@@@@@@@@@@@@   @@@@@@@@@@@@@@@@@@@@@   @@@@@@@@@@
@@@@@@@@   @@@@@@@@        @   @@@@@@   @@@@@@@@@   @@@@@@@@@@@@            @@@   @@@@@@@@@@@@@@@@@@@@@@   @@@@@@@@@
@@@@@@@@   @@@@@@@@        @   @@@@@@   @@@@@@@@@   @@@@@@@@@@@@            @@@   @@@@@@@@@@@@@@@@@@@@@@@   @@@@@@@@
@@@@@@@@   @@@@@@@@@@@@@   @   @@@@@@   @@@@@@@@@   @@@@@@@@@@@@   @@@@@@@@@@@@   @@@@@@@@@@@@@@@@@@@@@@@@   @@@@@@@
@@@@       @@@@@@@@@@@@@   @   @@@@@@   @@@@@@@@@   @@@@@@@@@@@@   @@@@@@@@@@@@   @@@@@@@@@@@@@@@@@@@@@@@@@   @@@@@@
@@@@                           @@@@@@   @@@@@@@@@                  @@@@@@@@       @@@@@@@@@@@@@@@@@@@@@@@@@@@@@@@@@@
@@@@   @@                      @@@@@@   @@@@@@@@@                  @@@@@@@@       @@@@@@@@@@@@@@@@@@@@@   @@@@@@@@@@
@@@@   @@@@@@@@@@@@@@@@@@@@@@@@@@@@@@   @@@@@@@@@   @@@@@@@@@@@@@@@@@@@@@@@   @@@@@@@@@@@@@@@@@@@@@@@@@   @@@@@@@@@@
@@@@   @@@@@@           @@@@            @@@@@@@@@   @@@@@@@@@@@@@@@@@@@@@@@   @@@@@@@@@@@@@@@@@@@@@@@@@   @@@@@@@@@@
@@@@   @@@@@@           @@@@            @@@@@@@@@   @@@@@@@@@@@@@@@@@@@@@@@                               @@@@@@@@@@
@@@@   @@@@@@   @@@@@   @@@@   @@@@@@@@@@@@@@@@@@   @@@@@@@@@@@@@@@@@@@@@@@                               @@@@@@@@@@
@@@@   @@@@@@   @@@@@   @@@@   @@@@@@@@@@@@@@@@@@   @@@@@@@@@@@@@@@@@@@@@@@@@@@@@@@@@@@@@@@   @@@@@@@@@@@@@@@@@@@@@@
@@@@   @@@@@@   @@@@@   @@@@   @@@@@@@@@@@@@@@@@@                           @@@@@@@@@@@@@@@   @@@@@@@@@@@@@@@@@@@@@@
@@@@   @@@@@@   @@@@@   @@@@   @@@@@@@@@@@@@@@@@@                           @@@@@@@@@@@@@@@   @@@@@@@@@@@@@@@@@@@@@@
@@@@   @@@@@@   @@@@@   @@@@         @@@@@@@@@@@@@@@@@@   @@@@@@@@@@@@@@@@@@@@@@@@@@@@@@@@@   @@@@@@@@@@@@@@@@@@@@@@
@@@@   @@@@@@   @@@@@   @@@@         @@@@@@@@@@@@@@@@@@   @@@@@@@@@@@@@@@@@@@@@@@@@@@@@@@@@   @@@@@@@@@@@@@@@@@@@@@@
@@@@   @@@@@@   @@@@@   @@@@@@@@@@   @@@@@@@@@@@@@@@@@@   @@@@@@@@@@@@@@@@@@@@@@@@@@@@@@@@@   @@@@@@@@@@@@@@@@@@@@@@
@@@@   @@@@@@   @@@@@   @@@@@@@@@@   @@@@@@@@@@@@@@@@@@   @@@@@@@@@@@@@@@@@@@@@@@@@@@@@@@@@   @@@@@@@@@@@@@@@@@@@@@@
@@@@   @@@@@@   @@@@@   @@@@@@@@@@   @@@@@@@@@@@@@@@@@@   @@@@@@@@@@@@@@@@@@@@@@@@@@@@@@@@@   @@@@@@@@@@@@@@@@@@@@@@
@@@@            @@@@@                     @     @         @@@@@@@@@@@@@@@@@@@@@@@@@@@@@@@@@   @@@@@@@@@@@@@@@@@@@@@@
@@@@            @@@@@                  @     @     @      @@@@@@@@@@@@@@@@@@@@@@@@@@@@@@@@@   @@@@@@@@@@@@@@@@@@@@@@
@@@@@@@@@@@@@@@@@@@@@@@@@@@@@@@@@@@@@@@@@@@@@@@@@@@@@@@@@@@@@@@@@@@@@@@@@@@@@@@@@@@@@@@@@@@   @@@@@@@@@@@@@@@@@@@@@@
@@@@@@@@@@@@@@@@@@@@@@@@@@@@@@@@@@@@@@@@@@@@@@@@@@@@@@@@@@@@@@@@@@@@@@@@@@@@@@@@@@@@@@@@@@@   @@@@@@@@@@@@@@@@@@@@@@
@@@@@@@@@@@@@@@@@@@@@@@@@@@@@@@@@@@@@@@@@@@@@@@@@@@@@@@@@@@@@@@@@@@@@@@@@@@@@@@@@@@@@@@@@@@   @@@@@@@@@@@@@@@@@@@@@@
@                               @@@                   @@@              @@@         @@@@@@@@   @@@@@@@@@@@@@@@@@@@@@@
@@                  @@@@        @@@      @@@          @@@         @@@                         @@@@@@@@@@@@@@@@@@@@@@
@@@                 @@@@                 @@@                      @@@    @@@@@@@@@@          @@@@@@@@@@@@@@@@@@@@@@@
@@@ #              @@@@@@@@@@@@@@@@@@@@@@@@@@@@@@@@@@@@@@@@@@@@@@@@@@@@@@@@@@@@@@@@@@@@@@@@@@@@@@@@@@@@@@@@@@@@@@@@@
@@@               @@@@@@@@@@@@@@@@@@@@@@@@@@@@@@@@@@@@@@@@@@@@@@@@@@@@@@@@@@@@@@@@@@@@@@@@@@@@@@@@@@@@@@@@@@@@@@@@@@
@@@@@@@@@@@@@@@@@@@@@@@@@@@@@@@@@@@@@@@@@@@@@@@@@@@@@@@@@@@@@@@@@@@@@@@@@@@@@@@@@@@@@@@@@@@@@@@@@@@@@@@@@@@@@@@@@@@@