@@@@@@@@@@@@@@@@@@@@@@@@@@@@@@@@@@@@@@@@@@@@@@@@@@@@@@@@@@@@@@@@@@@@@@@@@@@@@@@@@@@@@@@@@@@@@@@@@@@@@@@@@@@@@@@@@@@@
@@@@@@@@@@@@@@@@@@@@@@@@@@@@@@@@@@@@@@@@@@@@@@@                                @@@@@@@@@@@@@@@@@@@@@@@@@@@@@@@@@@@@@
@@@@@@@@@@@@@@@@@@@@@@@@@@@@@@@@@@@@@@@@@@@@@@@                                @@@@@@@@@@@@@                     @@@
@@@@@@@ *                                        @@@@@@@@@@@@@@@@  @@@@  @@@@  @@@@@@@@@@@@@                     @@@
@@@@@@@                                          @@@@@@@@@@@@@@@@  @@@@  @@@@  @@@@@@@@@@@@@@@@@@@@@@  @@@@@@@@@@@@@
@@@@@@@   @@@@@@@@@@@@@@@@@@@@@@@@@@@@@@@@@@@@@  @@@@@@@@@@@@@@@@  @@@@  @@@@  @@@@@@@@@@@@@@@@@@@@@@  @@@@@@@@@@@@@
@@@@@@@   @@@@@@@@@@@@@@@@@@@@@@@@@@@@@@@@@@@@@  @@@@@@@@@@@@@@@@  @@@@  @@@@  @@@@@@@@@@@@@@@@@@@@@@  @@@@@@@@@@@@@
@@@@@@@   @@@@@@@@@@@@@@@@@@@@@@@@@@@@@@@@@@@@@  @@@@@@@@@@@@@@@@  @@@@                                @@@@@@@@@@@@@
@@@@@@@   @@@@@@@@@@@@@@@@@@@@@@@@@@@@@@@@@@@@@  @@@@@@@@@@@@@@@@  @@@@  @@@@@@@@@@@@@@@@@@@@@@@@@@@@@@@@@@@@@@@@@@@
@@@@@@@   @@@@@@@@@@@@@@@@@@@@@@@@               @@@@@@@@@@@@@@@@                                 @@@@@@@@@@@@@@@@@@
@@@@@@@   @@@@@@@@@@@@@@@@@@@@@@@@               @@@@@@@@@@@@@@@@                                 @@@@@@@@@@@@@@@@@@
@@@@@@@   @@@@@@@@@@@@@@@@@@@@@@@@  @@@@@@@@@@@@@@@@@@@@@@@@@@@@@@@@@@@@@@@@@@@@@@@@@@@@@@@@@@@@  @@@@@@@@@@@@@@@@@@
@@@@@@@   @@@@@@@@@@@@@@@@@@@@@@@@  @@@@@@@@@@@@@@@@@@@@@@@@@@@@@@@@@@@@@@@@@@@@@@@@@@@@@@@@@@@@  @@@@@@@@@@@@@@@@@@
@@@@@@@   @@@@@@@@@@@@@@@@@@@@@@@@  @@@@@@@@@@@@@@@@@@@@@@@@@@@@@@@@@@@@@@@@@@@@@@@@@@@@@@@@@@@@  @@@@@@@@@@@@@@@@@@
@@@@@@@                                                                                        @  @@@@@@@@@@@@@@@@@@
@@@@@@@                                                                                        @  @@@@@@@@@@@@@@@@@@
@@@@@@@@@@@@@@@@@@@@@@@@@@@@@@@@@@  @@@@@@@@@@@  @@@@@@@@@@@@@@@@@@@@@@@@@@@@@@@@@@@@@@@@@@@@@@@  @@@@@@@@@@@@@@@@@@
@@@@@@@@@@@@@@@@@@@@@@@@@@@@@@@@@@  @@@@@@@@@@@  @@@@@@@@@@@@@@@@@@@@@@@@@@@@@@@@@@@@@@@@@@@@@@@  @@@@@@@@@@@@@@@@@@
@@@@@@@                        @@@  @@@@@@@@@@@  @@@@@@@@@@@@@@@@  @@@@ @@@@@  @@@@@@@@@@@@@@@@@  @@@@@@@@@@@@@@@@@@
@@@@@@@                        @@@  @@@@@@@@@@@  @@@@@@@@@@@@@@@@  @@@@ @@@@@  @@@@@@@@@@@@@@@@@  @@@@@@@@@@@@@@@@@@
@@@@@@@   @@@@@@@@@@@@@@@@@@@@@@@@  @@@@@@@@@@@  @@@@@@@@@@@@@@@@  @@@@ @@@@@  @@@@@@@@@@@@@@@@@  @@@@@@@@@@@@@@@@@@
@@@@@@@   @@@@@@@@@@@@@@@@@@@@@@@@  @@@@@@@@@@@  @@@@@@@@@@@@@@@@  @@@@ @@@@@  @@@@@@@@@@@@@@@@@  @@@@@@@@@@@@@@@@@@
@@@@@@@                             @@@@@@@@@@@  @@@@@@@@@@@@@@@@       @@@@@                     @@@@@@@@@@@@@@@@@@
@@@@@@@   @@@@@@@@@@@@@@@@@@@@@@@@@@@@@@@@@@@@@  @@@@@@@@@@@@@@@@  @@@@ @@@@@                                      @
@@@@@@@@@@@@@@@@@@@@@@@@@@@@@@@@@@@@@@@@@@@@@@@@@@@@@@@@@@@@@@@@@  @@@@ @@@@@  @@@@@@@@@@@@@@@@@  @@@@@@@@@@@@@@@@ @
@@@@@@@                                                                                           @@@@@@@@@@@@@@@@ @
@@@@@@@                                                                                           @@@@@@@@@@@@@@@@ @
@@@@@@@  @@@@@@@@@@@@@@@@@@@@@@@@@@@@@@@@@@@@@@@@@@@@@@@@@@@@@@@@@@@@@@@@@@@@@@@@@@@@@@@@@@@@@@@@@@@@@@@@@@@@@@@@@ @
@@@@@@@  @@@@@@@@@@@@@@@@@@@@@@@@@@@@@@@@@@@@@@@@@@@@@@@@@@@@@@@@@@@@@@@@@@@@@@@@@@@@@@@@@@@@@@@@@@@@@@@@@@@@@@@@@ @
@@@@@@@                                                                                           @@@@@@@@@@@@@@@@ @
@@@@@@@                                                                                           @@@@@@@@@@@@@@@@ @
@@@@@@@@@@@@@@@@@@@@@@@@@@@@@@@@@@@@@@@@@@@@@@@@@@@@@@@@@@@@@@@@@@@@@@@@@@@@@@@@@@@@@@@@@@@@@@@@  @@@@@@@@@@@@@@@@ @
@@@@@@@@@@@@@@@@@@@@@@@@@@@@@@@@@@@@@@@@@@@@@@@@@@@@@@@@@@@@@@@@@@@@@@@@@@@@@@@@@@@@@@@@@@@@@@@@  @@@@@@@@@@@@@@@@ @
@@@@@@@                                                                                           @@@@@@@@@@@@@@@@ @
@@@@@@@                                                                                           @@@@@@@@@@@@@@@@&@
@@@@@@@@@@@@@@@@@@@@@@@@@@@@@@@@@@@@@@@@@@@@@@@@@@@@@@@@@@@@@@@@@@@@@@@@@@@@@@@@@@@@@@@@@@@@@@@@                 &#@
@@@@@@@@@@@@@@@@@@@@@@@@@@@@@@@@@@@@@@@@@@@@@@@@@@@@@@@@@@@@@@@@@@@@@@@@@@@@@@@@@@@@@@@@@@@@@@@@@@@@@@@@@@@@@@@@@@@@