@@@@@@@@@@@@@@@@@@@@@@@@@@@@@@@@@@@@@@@@@@@@@@@@@@@@@@@@@@@@@@@@@@
@@@@@@@@@@@@@@@@@@@@@@@@@@@@@@@@@@@@@@@@@@@@@@@@@@@@@@@@@@@@@@@@@@
@*                                                              @@
@@@  @@@@@@@@@@@@@@@@@@@@@@@  @@@@@@@@@@@@@@@@@@@@@@@@@@@@@@@@  @@
@@@  @@@@@@@@@@@@@@@@@@@@@@@  @@@@@@@@@@@@@@@@@@@@@@@@@@@@@@@@  @@
@@@  @@                   @@  @@                                @@  
@@@  @@  @@@@@@@@@@@@@@@@@@@  @@@@@@  @@@@@@@@@@@@@@@@@@@@@@@@  @@
@@@@&@@  @@@@@@@@@@@@@@@@@@@  @@@@@@  @@@@@@@@@@@@@@@@@@@@@@@@  @@
@@@@&@@                       @@  @@  @@@@@@@@@@@@@@@@@@@@@@@@  @@
@@@@&@@@@@@@@@@@@@@@@@@@@@@@@@@@  @@                        @@  @@
@@@@&@@@@@@@@@@@@@@@@@@@@@@@@@@@  @@@@@@@@@@@@@@@@@@@@@@@@  @@  @@
@@@     #@@@@@@@@@@@@@@@@@@@@@@@  @@@@@@@@@@@@@@@@@@@@@@@@  @@  @@
@@@     #@@@@@@@@@@@@@@@@@@@@@@@                            @@  @@
@@@  @@@@@@@@@@@@@@@@@@@@@@@@@@@  @@@@@@@@@@@@@@@@@@@@@@@@@@@@@@@@
@@@  @@@@@@@@@@@@@@@@@@@@@@@@@@@  @@@@@@@@@@@@@@@@@@@@@@@@@@@@@@@@
@@@  @@      @@      @@     @@@@                            @@  @@
@@@  @@  @@  @@  @@  @@  @  @@@@@@@@@@@@@@@@   @@@@@@@@@@@@@@@  @@
@@@  @@  @@  @@  @@  @@  @  @@@@@@@@@@@@@@@@   @@@@@@@@@@@@@@@  @@
@@@  @@  @@  @@  @@  @@  @  @@@@@              @@           @@  @@
@@@  @@  @@  @@  @@  @@  @  @@@@@   @@@@@@@@@@@@@@@@@@  @@  @@  @@
@@@      @@      @@      @  @@@@@   @@@@@@@@@@@@@@@@@@  @@  @@  @@
@@@@@@@@@@@@@@@@@@@@@@@@@@  @@@@@   @@      @@      @@  @@      @@
@@@@@@@@@@@@@@@@@@@@@@@@@@  @@@@@   @@  @@  @@  @@  @@  @@@@@@  @@
@@@                         @@@@@       @@      @@      @@@@@@  @@
@@@  @@@@@@@@@@@@@@@@@@@@@@@@@@@@@@@@@@@@@@@@@@@@@@@@@@@@@@@@@  @@
@@@  @@@@@@@@@@@@@@@@@@@@@@@@@@@@@@@@@@@@@@@@@@@@@@@@@@@@@@@@@  @@
@@@                                                             @@
@@@@@@@@@@@@@@@@@@@@@@@@@@@@@@@@@@@@@@@@@@@@@@@@@@@@@@@@@@@@@@@@@@
@@@@@@@@@@@@@@@@@@@@@@@@@@@@@@@@@@@@@@@@@@@@@@@@@@@@@@@@@@@@@@@@@@
