@@@@@@@@@@@@@@@@@@@@@@@@@@@@@@@@@@@@@@@@@@@@@@@@@@@@@@@@@@@@@@@@@@@@@@@@@@@@@@@@@@@@@@@@@@@@@@@@@@@@@@@@@@@@@@@@@@@@
@@@@@@@@@@@@@@@@@@@@@@@@@@@@@@@@@@@@@@@@@@@@@@@@@@@@@@@@@@@@@@@@@@@@@@@@@@@@@@@@@@@@@@@@@@@@@@@@@@@@@@@@@@@@@@@@@@@@
@@@@@@@@@@@@@@@@@@@@@@@@@@@@@@@@@@@@@@@@@@@@@@@                                @@@@@@@@@@@@@@@@@@@@@@  @@@@@@@@@@@@@
@@@@@@@ * @@@@@@@@@@@@@@@@@@@@@@@@@@@@@@@@@@@@@  @@@@@@@@@@@@@@@@  @@@@@@@@@@  @@@@@@@@@@@@@@@@@@@@@@  @@@@@@@@@@@@@
@@@@@@@   @@@@@@@@@@@@@@@@@@@@@@@@@@@@@@@@@@@@@  @@@@@@@@@@@@@@@@  @@@@ @@@@@  @@@@@@@@@@@@@@@@@@@@@@  @@@@@@@@@@@@@
@@@@@@@   @@@@@@@@@@@@@@@@@@@@@@@@@@@@@@@@@@@@@  @@@@@@@@@@@@@@@@  @@@@ @@@@@  @@@@@@@@@@@@@@@@@@@@@@  @@@@@@@@@@@@@
@@@@@@@   @@@@@@@@@@@@@@@@@@@@@@@@@@@@@@@@@@@@@  @@@@@@@@@@@@@@@@  @@@@ @@@@@  @@@@@@@@@@@@@@@@@@@@@@  @@@@@@@@@@@@@
@@@@@@@   @@@@@@@@@@@@@@@@@@@@@@@@@@@@@@@@@@@@@  @@@@@@@@@@@@@@@@  @@@@                                @@@@@@@@@@@@@
@@@@@@@   @@@@@@@@@@@@@@@@@@@@@@@@@@@@@@@@@@@@@  @@@@@@@@@@@@@@@@  @@@@@@@@@@@@@@@@@@@@@@@@@@@@@@@@@@@@@@@@@@@@@@@@@
@@@@@@@   @@@@@@@@@@@@@@@@@@@@@@@@                @@@@@@@@@@@@@@@  @@@@@@@@@@@@@@@@@@@@@@@@@@@@@@@@@@@@@@@@@@@@@@@@@
@@@@@@@   @@@@@@@@@@@@@@@@@@@@@@@@                @@@@@@@@@@@@@@@                                 @@@@@@@@@@@@@@@@@@
@@@@@@@   @@@@@@@@@@@@@@@@@@@@@@@@  @@@@@@@@@@@@@@@@@@@@@@@@@@@@@@@@@@@@@@@@@@@@@@@@@@@@@@@@@@@@  @@@@@@@@@@@@@@@@@@
@@@@@@@   @@@@@@@@@@@@@@@@@@@@@@@@  @@@@@@@@@@@@@@@@@@@@@@@@@@@@@@@@@@@@@@@@@@@@@@@@@@@@@@@@@@@@  @@@@@@@@@@@@@@@@@@
@@@@@@@   @@@@@@@@@@@@@@@@@@@@@@@@  @@@@@@@@@@@@@@@@@@@@@@@@@@@@@@@@@@@@@@@@@@@@@@@@@@@@@@@@@@@@  @@@@@@@@@@@@@@@@@@
@@@@@@@                                                                                   @@@@@@  @@@@@@@@@@@@@@@@@@
@@@@@@@                                                                                   @@@@@@  @@@@@@@@@@@@@@@@@@
@@@@@@@@@@@@@@@@@@@@@@@@@@@@@@@@@@  @@@@@@@@@@@@  @@@@@@@@@@@@@@@@@@@@@@@@@@@@@@@@@@@@@@@@@@@@@@  @@@@@@@@@@@@@@@@@@
@@@@@@@@@@@@@@@@@@@@@@@@@@@@@@@@@@  @@@@@@@@@@@@  @@@@@@@@@@@@@  @@@@@@@@@@@@@@@@@@@@@@@@@@@@@@@  @@@@@@@@@@@@@@@@@@
@@@@@@@@@@@@@              @@@@@@@  @@@@@@@@@@@@  @@@@@@@@@@@@@  @@@@@@@@@@@@@@@@@@@@@@@@@@@@@@@  @@@@@@@@@@@@@@@@@@
@@@@@@@@@@@@@  @@@@  @@@@  @@@@@@@  @@@@          @@@@@@@@@@@@@               @@@@@@@@@@@@@@@@@@  @@@@@@@@@@@@@@@@@@
@@@@@@@@@@@@@  @@@@  @@@@  @@@@@@@  @@@@  @@@@@@@@@@@@@@@@@@@@@  @@@@@@@@@@@@@@@@@@@@@@@@@@@@@@@  @@@@@@@@@@@@@@@@@@
@@@@@@@@@@@@@  @@@@  @@@@  @@@@@@@  @@@@  @@@@@@@@@@@@@@@@@@@@@  @@@@@@@@@@@@@@@@@@@@@@@@@@@@@@@  @@@@@@@@@@@@@@@@@@
@@@@@@@@@@@@@              @@@@@@@  @@@@  @@@@@@@@@@@@@@@@@@@@@  @@@@@@@@@@@@@@@@@@@@@@@@@@@@@@@  @@@@@@@@@@@@@@@@@@
@@@@@@@@@@@@@  @@@@  @@@@  @@@@@@@  @@@@  @@@@                                          @@@@@@@@  @@@@@@@@@@@@@@@@@@
@@@@@@@@@@@@@  @@@@  @@@@  @@@@@@@  @@@@  @@@@  @@@@@@@@@@@@@@@@@@@@@@@@@@@@@@@@@@@@@@@@@@@@@@@@  @@@@@@@@@@@@@@@@@@
@@@@@@@@@@@@@  @@@@  @@@@  @@@@@@@  @@@@  @@@@  @@@@@@@@@@@@@@@@@@@@@@@@@@@@@@@@@@@@@@@@@@@@@@@@  @@@@@@@@@@@@@@@@@@
@@@@@@@@@@@@@              @@@@@@@  @@@@  @@@@  @@@@@@@@@@@@@@@@@@@@@@@@@@@@@@@@@@@@@@@@@@@@@@@@  @@@@@@@@@@@@@@@@@@
@@@@@@@@@@@@@@@@@@@  @@@@@@@@@@@@@  @@@@  @@@@  @@@@@@@@@@@@@@@@@@@@                                   @@@@@@@@@@@@@
@@@@@@@@@@@@@@@@@@@  @@@@@@@@@@@@@  @@@@  @@@@  @@@@@@@@@@@@@@@@@@@@  @@@@@@@@@@@@@@@@@@@@@@@@@@  @@@@@@@@@@@@@@@@@@
@@@@@@@@@@@@@@@@@@@  @@@@@@@@@@@@@  @@@@  @@@@  @@@@@@@@@@@@@@@@@@@@  @@@@@@@@@@@@@@@@@@@@@@@@@@  @@@@@@@@@@@@@@@@@@
@@@@@@@@@@@@@@@@@@@  @@@@@@@@@@@@@  @@@@  @@@@  @@@@@@@@@@@@@@@@@@@@  @@@@@@@@@@@@@@@@@@@@@@@@@@  @@@@@@@@@@@@@@@@@@
@@@@@@@@@@@@@@@@@@@  @@@@@@@@@@@@@  @@@@  @@@@  @@@@@@@@@@@@@@@@@@@@  @@@@@@@@@@@@@@@@@@@@@@@@@@  @@@@@@@@@@@@@@@@@@
@@@@@@@@@@@@@@@@@@@  @@@@@@@@@@@@@  @@@@  @@@@  @@@@@@@@@@@@@@@@@@@@  @@@@@@@@@@@@@@@@@@@@@@@@@@  @@@@@@@@@@@@@@@@@@
@@@@@@@@@@@@@@@@@@@  @@@@@@@@@@@@@  @@@@  @@@@  @@@@@@@@@@@@@@@@@@@@  @@@@@@@@@@@@@@@@@@@@@@@@@@  @@@@@@@@@@@@@@@@@@
@@@@@@@@@@@@@@@@@@@  @@@@@@@@@@@@@  @@@@  @@@@  @@@@@@@@@@@@@@@@@@@@  @@@@@@@@@@@@@@@@@@@@@@@@@@  @@@@@@@@@@@@@@@@@@
@@@@@@@@@@@@@@@@@@@  @@@@@@@@@@@@@  @@@@  @@@@  @@@@@@@@@@@@@@@@@@@@  @@@@@@@@@@@@@@@@@@@@@@@@@@  @@@@@@@@@@@@@@@@@@
@@@@@@@@@@@@@@@@@@@  @@@@@@@@@@@@@  @@@@  @@@@  @@@@@@@@@@@@@@@@@@@@  @@@@@@@@@@@@@@@@@@@@@@@@@@  @@@@@@@@@@@@@@@@@@
@@@@@@@@@@@@@@@@@@@  @@@@@@@@@@@@@  @@@@@@@@@@  @@@@@@@@@@@@@@@@@@@@  @@@@@@@@@@@@@@@@@@@@@@@@@@  @@@@@@@@@@@@@@@@@@
@@@@@@@@@@@@@@@@@@@  @@@@@@@@@@@@@  @@@@@@@@@@  @@@@@@@@@@@@@@@@@@@@  @@@@@@@@@@@@@@@@@@@@@@@@@@@@@@@@@@@@@@@@@@@@@@
@@@@@@@@@@@@@@@@@@@                 @@@@@@@@@@  @@@@@@@@@@@@@@@@@@@@  @@@@@@@@@@@@@@@@@@@@@@@@@@@@@@@@@@@@@@@@@@@@@@
@@@@@@@@@@@@@@@@@@@@@@@@@@@@@@@@@@  @@@@@@@@@@  @@@@@@@@@@@@@@@@@@@@  @@@@@@@@@@@@@@@@@@@@@@@@@@@@@@@@@@@@@@@@@@@@@@
@@@@@@@@@@@@@@@@@@@@@@@@@@@@@@@@@@                               @@@                             @@@@@@@@@@@@@@@@@@@
@@@@@@@@@@@@@@@@@@@@@@@@@@@@@@@@@@  @@@@@@@@@@@@@@@@@@@@@@@@@@@@@@@@  @@@@@@@@@@@@@@@@@@@@@@@@@@@@@@@@@@@@@@@@@@@@@@
@@@@@@@@@@@@@@@@@@@@@@@@@@@@@@@@@@  @@@@@@@@@@@@@@@@@@@@@@@@@@@@@@@@  @@@@@@@@@@@@@@@@@@@@@@@@@@@@@@@@@@@@@@@@@@@@@@
@@@@@@@@@@@@@@@@@@@@@@@@@@@@@@@@@@  @@@@@@@@@@@@@@@@@@@@@@@@@@@@@@@@  @@@@@@@@@@@@@@@@@@@@@@@@@@@@@@@@@@@@@@@@@@@@@@
@@@@@@@@@@@@@@@@@@@@@@@@@@@@@@@@@@  @@@@@@@@@@@@@@@@@@@@@@@@@@@@@@@@  @@@@@@@@@@@@@@@@@@@@@@@@@@@@@@@@@@@@@@@@@@@@@@
@@@@@@@@@@@@@@@@@@@@@@@@@@@@@@@@@@  @@@@@@@@@@@@@@@@@@@@@@@@@@@@@@@@  @@@@@@@@@@@@@@@@@@@@@@@@@@@@@@@@@@@@@@@@@@@@@@
@@@@@@@@@@@@@@@@@@@@@@@@@@@@@@@@@@@@@@@@@@@@@@@@@@@@@@@@@@@@@@@@@@@@  @@@@@@@@@@@@@@@@@@@@@@@@@@@@@@@@@@@@@@@@@@@@@@
@@@@@@@@@@@@@@@@@@@@@@@@@@@@@@@@@@@@@@@@@@@@@@@@@@@@@@@@@@@@@@@@@@@@                                   #@@@@@@@@@@@@
@@@@@@@@@@@@@@@@@@@@@@@@@@@@@@@@@@@@@@@@@@@@@@@@@@@@@@@@@@@@@@@@@@@@@@@@@@@@@@@@@@@@@@@@@@@@@@@@@@@@@@@@@@@@@@@@@@@@
@@@@@@@@@@@@@@@@@@@@@@@@@@@@@@@@@@@@@@@@@@@@@@@@@@@@@@@@@@@@@@@@@@@@@@@@@@@@@@@@@@@@@@@@@@@@@@@@@@@@@@@@@@@@@@@@@@@@
