@@@@@@@@@@@@@@@@@@@@@@@@@@@@@@@@@@@@@@@@@@@@@@@@@@@@@@@@@@@@@@@@@@@@@@@@@@@@@@@@@@@@@@@@@@@@@@@@@@@@@@@@@@@@@@@@@@@@
@@@@@@@@@@@@@@@@@@@@@@@@@@@@@@@@@@@@@                                                                           @@@@
@@@@@@@@ * @@@@@@@@@@@@@@@@@@@@@@@@@@   @@@@@@@@@@@@@@@@@@@@@@@@@@@@@@@@@@@@@@@@@@@@@@@@@@@@@@@@@@@@@@@@@@@@@@@@@@@@
@@@@@@@@   @@@                 @@@@@@                         @@@@@@@@@@@@@@@@@@@@@@@@@@@@@@@@@@@@@@@@@@@@@@@@@@@@@@
@@@@@@@@   @@@                 @@@@@@                         @@@@@@@@@@                                  @@@@@@@@@@
@@@@@@@@   @@@   @@@@@@@@@@@   @@@@@@   @@@@@@@@@@@@@@@@@@@   @@@@@@@@@@                                  @@@@@@@@@@
@@@@@@@@   @@@   @@@@@@@@@@@   @@@@@@   @@@@@@@@@@@@@@@@@@@   @@@@@@@@@@   @@@@   @@@@@@@@@@@@@@@@@@@@@   @@@@@@@@@@
@@@@@@@@   @@@   @@@@@@@@@@@   @@@@@@   @@@@@@@@@@@@@@@@@@@   @@@@@@@@@@   @@@@   @@@@@@@@@@@@@@@@@@@@@   @@@@@@@@@@
@@@@@@@@   @@@   @@@@@@@@@@@   @@@@@@   @@@@@@@@@@@@@@@@@@@   @@@@@@@@@@   @@@@   @@@@@@@@@@@@@@@@@@@@@   @@@@@@@@@@
@          @@@   @@@@@@@@@@@   @@@@@@   @@@@@@@@@@@@@@@@@@@   @@@@@@@@@@   @@@@   @@@@@@@@@@@@@@@@@@@@@   @@@@@@@@@@
@          @@@   @@@@@@@@@@@   @@@@@@   @@@@@@@@@@@@@@@@@@@   @@@@@@@@@@   @@@@   @@@@@@@@@@@@@@@@@@@@@   @@@@@@@@@@
@ @@@@@@   @@@   @@@@@@@@@@@   @@@@@@   @@@@@@@@@@@@@         @@@@@@@@@@   @@@@   @@@@@@@@@@@@@@@@@@@@@   @@@@@@@@@@
@ @@@@@@   @@@   @@@@@@@@@@@   @@@@@@   @@@@@@@@@@@@@         @@@@@@@@@@   @@@@   @@@@@@@@@@@@@@@@@@@@@   @@@@@@@@@@
@ @@@@@@   @@@   @@@@@@@@@@@   @@@@@@   @@@@@@@@@@@@@   @@@@@@@@@@@@@@@@   @@@@   @@@@@@@@@@@@@@@@@@@@@   @@@@@@@@@@
@ @@@@@@   @@@   @@@@@@@@@@@   @@@@@@   @@@@@@@@@@@@@   @@@@@@@@@@@@@@@@   @@@@   @@@@@@@@@@@@@@@@@@@@@   @@@@@@@@@@
@ @@@@@@   @@@   @@@@@@@@@@@   @@@@@@   @@@@@@@@@   @   @@@@@@@@@@@@@@@@   @@@@   @@@@@@@@@@@@@@@@@@@@@   @@@@@@@@@@
@ @@@@@@         @@@@@@@@@@@   @@@@@@   @@@@@@@@@   @                      @@@@   @@@@@@@@@@@@@@@@@@@@@   @@@@@@@@@@
@ @@@@@@         @@@@@@@@@@@   @@@@@@   @@@@@@@@@   X                      @@@@   @@@@@@@@@@@@@@@@@@@@@   @@@@@@@@@@
@ @@@@@@   @@@@@@@@@@@@@@@@@   @@@@@@   @@@@@@@@@   @@@@@@@@@@@@@@@@@@@@@@@@@@@   @@@@@@@@@@@@@@@@@@@@@   @@@@@@@@@@
@ @@@@@@   @@@@@@@@        @   @@@@@@   @@@@@@@@@   @@@@@@@@@@@@            @@@   @@@@@@@@@@@@@@@@@@@@@@   @@@@@@@@@
@ @@@@@@   @@@@@@@@        @   @@@@@@   @@@@@@@@@   @@@@@@@@@@@@            @@@   @@@@@@@@@@@@@@@@@@@@@@@   @@@@@@@@
@ @@@@@@   @@@@@@@@@@@@@   @   @@@@@@   @@@@@@@@@   @@@@@@@@@@@@   @@@@@@@@@@@@   @@@@@@@@@@@@@@@@@@@@@@@@   @@@@@@@
@ @@       @@@@@@@@@@@@@   @   @@@@@@   @@@@@@@@@   @@@@@@@@@@@@   @@@@@@@@@@@@   @@@@@@@@@@@@@@@@@@@@@@@@@   @@@@@@
@ @@                           @@@@@@   @@@@@@@@@                  @@@@@@@@       @@@@@@@@@@@@@@@@@@@@@@@@@@@ @@@@@@
@ @@   @@                      @@@@@@   @@@@@@@@@                  @@@@@@@@       @@@@@@@@@@@@@@@@@@@@@   @@@ @@@@@@
@ @@   @@@@@@@@@@@@@@@@@@@@@@@@@@@@@@   @@@@@@@@@   @@@@@@@@@@@@@@@@@@@@@@@   @@@@@@@@@@@@@@@@@@@@@@@@@   @@@ @@@@@@
@ @@   @@@@@@           @@@@            @@@@@@@@@   @@@@@@@@@@@@@@@@@@@@@@@   @@@@@@@@@@@@@@@@@@@@@@@@@   @@@ @@@@@@
@ @@   @@@@@@           @@@@            @@@@@@@@@   @@@@@@@@@@@@@@@@@@@@@@@                               @@@ @@@@@@
@ @@   @@@@@@   @@@@@   @@@@   @@@@@@@@@@@@@@@@@@   @@@@@@@@@@@@@@@@@@@@@@@                               @@@ @@@@@@
@ @@   @@@@@@   @@@@@   @@@@   @@@@@@@@@@@@@@@@@@   @@@@@@@@@@@@@@@@@@@@@@@@@@@@@@@@@@@@@@@   @@@@@@@@@@@@@@@ @@@@@@
@ @@   @@@@@@   @@@@@   @@@@   @@@@@@@@@@@@@@@@@@                           @@@@@@@@@@@@@@@   @@@@@@@@@@@@@@@ @@@@@@
@ @@   @@@@@@   @@@@@   @@@@   @@@@@@@@@@@@@@@@@@                           @@@@@@@@@@@@@@@   @@@@@@@@@@@@@@@ @@@@@@
@ @@   @@@@@@   @@@@@   @@@@         @@@@@@@@@@@@@@@@@@   @@@@@@@@@@@@@@@@@@@@@@@@@@@@@@@@@   @@@@@@@@@@@@@@@ @@@@@@
@ @@   @@@@@@   @@@@@   @@@@         @@@@@@@@@@@@@@@@@@   @@@@@@@@@@@@@@@@@@@@@@@@@@@@@@@@@   @@@@@@@@@@@@@@@ @@@@@@
@ @@   @@@@@@   @@@@@   @@@@@@@@@@   @@@@@@@@@@@@@@@@@@   @@@@@@@@@@@@@@@@@@@@@@@@@@@@@@@@@   @@@@@@@@@@@@@@@ @@@@@@
@ @@   @@@@@@   @@@@@   @@@@@@@@@@   @@@@@@@@@@@@@@@@@@   @@@@@@@@@@@@@@@@@@@@@@@@@@@@@@@@@   @@@@@@@@@@@@@@@ @@@@@@
@ @@   @@@@@@   @@@@@   @@@@@@@@@@   @@@@@@@@@@@@@@@@@@   @@@@@@@@@@@@@@@@@@@@@@@@@@@@@@@@@   @@@@@@@@@@@@@@@ @@@@@@
@ @@            @@@@@                     @     @         @@@@@@@@@@@@@@@@@@@@@@@@@@@@@@@@@   @@@@@@@@@@@@@@@ @@@@@@
@ @@            @@@@@                  @     @     @      @@@@@@@@@@@@@@@@@@@@@@@@@@@@@@@@@   @@@@@@@@@@@@@@@ @@@@@@
@ @@            @@@@@@@@@@@@@@@@@@@@@@@@@@@@@@@@@@@@@@@@@@@@@@@@@@@@@@@@@@@@@@@@@@@@@@@@@@@   @@@@@@@@@@@@@@@ @@@@@@
@ @@            @@@@@@@@@@@@@@@@@@@@@@@@@@@@@@@@@@@@@@@@@@@@@@@@@@@@@@@@@@@@@@@@@@@@@@@@@@@   @@@@@@@@@@@@@@@ @@@@@@
@ @@@@@@@@@@@@@X@@@@@@@@@@@@@@@@@@@@@@@@@@@@@@@@@@@@@@@@@@@@@@@@@@@@@@@@@@@@@@@@@@@@@@@@@@@   @@@@@@@@@@@@@@@ @@@@@@
@ @                             @@@                   @@@              @@@         @@@@@@@@   @@@@@@@@@@@@@@@ @@@@@@
@ @                 @@@@        @@@      @@@          @@@         @@@                         @@@@@@@@@@@@@@@ @@@@@@
@ @#                 @@@@                 @@@                      @@@    @@@@@@@@@@          @@@@@@@@@@@@@@@  @@@@@
@ @@@@@@@@@@@@@@@@@@@@@@@@@@@@@@@@@@@@@@@@@@@@@@@@@@@@@@@@@@@@@@@@@@@@@@@@@@@@@@@@@@@@@@@@@@@@@@@@@@@@@@@@@@@  @@@@@
@                                                                                                              @@@@@
@@@@@@@@@@@@@@@@@@@@@@@@@@@@@@@@@@@@@@@@@@@@@@@@@@@@@@@@@@@@@@@@@@@@@@@@@@@@@@@@@@@@@@@@@@@@@@@@@@@@@@@@@@@@@@@@@@@@